NO ./texture/forest/grass_1.png
SO ./texture/forest/grass_2.png
WE ./texture/forest/bark_2.png
EA ./texture/forest/bark_1.png

F 35,90,35
C 30,30,145




1111111111111111111111111
1000000000110000000000001
1011000001110000000000001
100100000000000000000000111111111
111111111011000001110000000000001
100000000011000001110111111111101
11110111111111011100000010001 101
11110111111111011101010010001 101
11000000110101011100000010001 101
10000000000000000000000011111 101
10000000000000001101010010001110111111
11000001110101011111011010E00000000001
11110111 1110101 101111010001111111111
11111111 1111111 111111111111

