NO ./texture/spongebob/Crabs.png
SO ./texture/spongebob/CrossCrab.png
WE ./texture/spongebob/Homes.png
EA ./texture/spongebob/Sunset.png

F 120,100,0
C 125,30,0




1111111111111111111111111
1000000000110000000000001
1011000001110000000000001
100100000000000000000000111111111
111111111011000001110000000000001
100000000011000001110111111111101
11110111111111011100000010001 101
11110111111111011101010010001 101
11000000110101011100000010001 101
10000000000000000000000011111 101
10000000000000001101010010001110111111
11000001110101011111011010N00000000001
11110111 1110101 101111010001111111111
11111111 1111111 111111111111
