NO ./texture/punisher.png
SO ./texture/Block.png
WE ./texture/Block.png
EA ./texture/Block.png

F 100,100,100
C 100,70,50



111111111111111111
100000000000000001
100001100000000001
100001000000000001
10000000W000000001
100000000000000001
100000000000000001
100000000000000001
111111111111111111
