NO ./texture/North.png
SO ./texture/South.png
WE ./texture/punisher.png
EA ./texture/East.png

F 100,100,100
C 100,70,50



111111111111111111
100000001000000001
100000000001000001
100000000000000001
100000000000000001
100000000000000001
10000W000000000001
100000000000000001
111111111111111111
